ab	Аҧсшәа (Abkhazian)
ace	Acèh (Achinese)
ady	адыгабзэ (Adyghe)
af	Afrikaans (Afrikaans)
ak	Akan (Akan)
als	Alemannisch (Alemannisch)
am	አማርኛ (Amharic)
an	aragonés (Aragonese)
ang	Ænglisc (Old English)
ar	العربية (Arabic)
arc	ܐܪܡܝܐ (Aramaic)
arz	مصرى (Egyptian Arabic)
as	অসমীয়া (Assamese)
ast	asturianu (Asturian)
av	авар (Avaric)
ay	Aymar aru (Aymara)
az	azərbaycanca (Azerbaijani)
azb	تۆرکجه (تۆرکجه)
ba	башҡортса (Bashkir)
bar	Boarisch (Bavarian)
bat-smg	žemaitėška (Samogitian)
bcl	Bikol Central (Bikol Central)
be	беларуская (Belarusian)
be-x-old	беларуская (тарашкевіца)‎ (беларуская (тарашкевіца)‎)
bg	български (Bulgarian)
bh	भोजपुरी (भोजपुरी)
bi	Bislama (Bislama)
bjn	Bahasa Banjar (Banjar)
bm	bamanankan (Bambara)
bn	বাংলা (Bengali)
bo	བོད་ཡིག (Tibetan)
bpy	বিষ্ণুপ্রিয়া মণিপুরী (Bishnupriya)
br	brezhoneg (Breton)
bs	bosanski (Bosnian)
bug	ᨅᨔ ᨕᨘᨁᨗ (Buginese)
bxr	буряад (буряад)
ca	català (Catalan)
cbk-zam	Chavacano de Zamboanga (Chavacano de Zamboanga)
cdo	Mìng-dĕ̤ng-ngṳ̄ (Min Dong Chinese)
ce	нохчийн (Chechen)
ceb	Cebuano (Cebuano)
ch	Chamoru (Chamorro)
chr	ᏣᎳᎩ (Cherokee)
chy	Tsetsêhestâhese (Cheyenne)
ckb	کوردیی ناوەندی (Central Kurdish)
co	corsu (Corsican)
cr	Nēhiyawēwin / ᓀᐦᐃᔭᐍᐏᐣ (Cree)
crh	qırımtatarca (Crimean Turkish)
cs	čeština (Czech)
csb	kaszëbsczi (Kashubian)
cu	словѣньскъ / ⰔⰎⰑⰂⰡⰐⰠⰔⰍⰟ (Church Slavic)
cv	Чӑвашла (Chuvash)
cy	Cymraeg (Welsh)
da	dansk (Danish)
de	Deutsch (German)
diq	Zazaki (Zazaki)
dsb	dolnoserbski (Lower Sorbian)
dv	ދިވެހިބަސް (Divehi)
dz	ཇོང་ཁ (Dzongkha)
ee	eʋegbe (Ewe)
el	Ελληνικά (Greek)
eml	emiliàn e rumagnòl (Emiliano-Romagnolo)
en	English (English)
eo	Esperanto (Esperanto)
es	español (Spanish)
et	eesti (Estonian)
eu	euskara (Basque)
ext	estremeñu (Extremaduran)
fa	فارسی (Persian)
ff	Fulfulde (Fulah)
fi	suomi (Finnish)
fiu-vro	Võro (Võro)
fj	Na Vosa Vakaviti (Fijian)
fo	føroyskt (Faroese)
fr	français (French)
frp	arpetan (Arpitan)
frr	Nordfriisk (Northern Frisian)
fur	furlan (Friulian)
fy	Frysk (Western Frisian)
ga	Gaeilge (Irish)
gag	Gagauz (Gagauz)
gan	贛語 (Gan Chinese)
gd	Gàidhlig (Scottish Gaelic)
gl	galego (Galician)
glk	گیلکی (Gilaki)
gn	Avañe'ẽ (Guarani)
gom	गोंयची कोंकणी / Gõychi Konknni (Goan Konkani)
got	𐌲𐌿𐍄𐌹𐍃𐌺 (Gothic)
gu	ગુજરાતી (Gujarati)
gv	Gaelg (Manx)
ha	Hausa (Hausa)
hak	客家語/Hak-kâ-ngî (Hakka Chinese)
haw	Hawaiʻi (Hawaiian)
he	עברית (Hebrew)
hi	हिन्दी (Hindi)
hif	Fiji Hindi (Fiji Hindi)
hr	hrvatski (Croatian)
hsb	hornjoserbsce (Upper Sorbian)
ht	Kreyòl ayisyen (Haitian Creole)
hu	magyar (Hungarian)
hy	Հայերեն (Armenian)
ia	interlingua (Interlingua)
id	Bahasa Indonesia (Indonesian)
ie	Interlingue (Interlingue)
ig	Igbo (Igbo)
ik	Iñupiak (Inupiaq)
ilo	Ilokano (Iloko)
io	Ido (Ido)
is	íslenska (Icelandic)
it	italiano (Italian)
iu	ᐃᓄᒃᑎᑐᑦ/inuktitut (Inuktitut)
ja	日本語 (Japanese)
jbo	la .lojban. (Lojban)
jv	Basa Jawa (Javanese)
ka	ქართული (Georgian)
kaa	Qaraqalpaqsha (Kara-Kalpak)
kab	Taqbaylit (Kabyle)
kbd	Адыгэбзэ (Kabardian)
kg	Kongo (Kongo)
ki	Gĩkũyũ (Kikuyu)
kk	қазақша (Kazakh)
kl	kalaallisut (Kalaallisut)
km	ភាសាខ្មែរ (Khmer)
kn	ಕನ್ನಡ (Kannada)
ko	한국어 (Korean)
koi	Перем Коми (Komi-Permyak)
krc	къарачай-малкъар (Karachay-Balkar)
ks	कॉशुर / کٲشُر (Kashmiri)
ksh	Ripoarisch (Colognian)
ku	Kurdî (Kurdish)
kv	коми (Komi)
kw	kernowek (Cornish)
ky	Кыргызча (Kyrgyz)
la	Latina (Latin)
lad	Ladino (Ladino)
lb	Lëtzebuergesch (Luxembourgish)
lbe	лакку (лакку)
lez	лезги (Lezghian)
lg	Luganda (Ganda)
li	Limburgs (Limburgish)
lij	Ligure (Ligurian)
lmo	lumbaart (Lombard)
ln	lingála (Lingala)
lo	ລາວ (Lao)
lrc	لۊری شومالی (Northern Luri)
lt	lietuvių (Lithuanian)
ltg	latgaļu (Latgalian)
lv	latviešu (Latvian)
mai	मैथिली (Maithili)
map-bms	Basa Banyumasan (Basa Banyumasan)
mdf	мокшень (Moksha)
mg	Malagasy (Malagasy)
mhr	олык марий (Eastern Mari)
mi	Māori (Maori)
min	Baso Minangkabau (Minangkabau)
mk	македонски (Macedonian)
ml	മലയാളം (Malayalam)
mn	монгол (Mongolian)
mr	मराठी (Marathi)
mrj	кырык мары (Western Mari)
ms	Bahasa Melayu (Malay)
mt	Malti (Maltese)
mwl	Mirandés (Mirandese)
my	မြန်မာဘာသာ (Burmese)
myv	эрзянь (Erzya)
mzn	مازِرونی (Mazanderani)
na	Dorerin Naoero (Nauru)
nah	Nāhuatl (Nāhuatl)
nap	Napulitano (Neapolitan)
nds	Plattdüütsch (Low German)
nds-nl	Nedersaksies (Low Saxon)
ne	नेपाली (Nepali)
new	नेपाल भाषा (Newari)
nl	Nederlands (Dutch)
nn	norsk nynorsk (Norwegian Nynorsk)
no	norsk bokmål (Norwegian)
nov	Novial (Novial)
nrm	Nouormand (Nouormand)
nso	Sesotho sa Leboa (Northern Sotho)
nv	Diné bizaad (Navajo)
ny	Chi-Chewa (Nyanja)
oc	occitan (Occitan)
om	Oromoo (Oromo)
or	ଓଡ଼ିଆ (Oriya)
os	Ирон (Ossetic)
pa	ਪੰਜਾਬੀ (Punjabi)
pag	Pangasinan (Pangasinan)
pam	Kapampangan (Pampanga)
pap	Papiamentu (Papiamento)
pcd	Picard (Picard)
pdc	Deitsch (Pennsylvania German)
pfl	Pälzisch (Palatine German)
pi	पालि (Pali)
pih	Norfuk / Pitkern (Norfuk / Pitkern)
pl	polski (Polish)
pms	Piemontèis (Piedmontese)
pnb	پنجابی (Western Punjabi)
pnt	Ποντιακά (Pontic)
ps	پښتو (Pashto)
pt	português (Portuguese)
qu	Runa Simi (Quechua)
rm	rumantsch (Romansh)
rmy	Romani (Romani)
rn	Kirundi (Rundi)
ro	română (Romanian)
roa-rup	armãneashti (Aromanian)
roa-tara	tarandíne (tarandíne)
ru	русский (Russian)
rue	русиньскый (Rusyn)
rw	Kinyarwanda (Kinyarwanda)
sa	संस्कृतम् (Sanskrit)
sah	саха тыла (Sakha)
sc	sardu (Sardinian)
scn	sicilianu (Sicilian)
sco	Scots (Scots)
sd	سنڌي (Sindhi)
se	sámegiella (Northern Sami)
sg	Sängö (Sango)
sh	srpskohrvatski / српскохрватски (Serbo-Croatian)
si	සිංහල (Sinhala)
sk	slovenčina (Slovak)
sl	slovenščina (Slovenian)
sm	Gagana Samoa (Samoan)
sn	chiShona (Shona)
so	Soomaaliga (Somali)
sq	shqip (Albanian)
sr	српски / srpski (Serbian)
srn	Sranantongo (Sranan Tongo)
ss	SiSwati (Swati)
st	Sesotho (Southern Sotho)
stq	Seeltersk (Saterland Frisian)
su	Basa Sunda (Sundanese)
sv	svenska (Swedish)
sw	Kiswahili (Swahili)
szl	ślůnski (Silesian)
ta	தமிழ் (Tamil)
te	తెలుగు (Telugu)
tet	tetun (Tetum)
tg	тоҷикӣ (Tajik)
th	ไทย (Thai)
ti	ትግርኛ (Tigrinya)
tk	Türkmençe (Turkmen)
tl	Tagalog (Tagalog)
tn	Setswana (Tswana)
to	lea faka-Tonga (Tongan)
tpi	Tok Pisin (Tok Pisin)
ts	Xitsonga (Tsonga)
tt	татарча/tatarça (Tatar)
tum	chiTumbuka (Tumbuka)
tw	Twi (Twi)
ty	reo tahiti (Tahitian)
tyv	тыва дыл (Tuvinian)
udm	удмурт (Udmurt)
ug	ئۇيغۇرچە / Uyghurche (Uyghur)
uk	українська (Ukrainian)
ur	اردو (Urdu)
uz	oʻzbekcha/ўзбекча (Uzbek)
ve	Tshivenda (Venda)
vec	vèneto (Venetian)
vep	vepsän kel’ (Veps)
vi	Tiếng Việt (Vietnamese)
vls	West-Vlams (West Flemish)
vo	Volapük (Volapük)
wa	walon (Walloon)
war	Winaray (Waray)
wo	Wolof (Wolof)
wuu	吴语 (Wu Chinese)
xal	хальмг (Kalmyk)
xh	isiXhosa (Xhosa)
xmf	მარგალური (Mingrelian)
yi	ייִדיש (Yiddish)
yo	Yorùbá (Yoruba)
za	Vahcuengh (Zhuang)
zea	Zeêuws (Zeelandic)
zh	中文 (Chinese)
zh-classical	文言 (Classical Chinese)
zh-min-nan	Bân-lâm-gú (Chinese (Min Nan))
zh-yue	粵語 (Cantonese)
zu	isiZulu (Zulu)
